? + . . >
. @ . ! .
. g > g ?
> . @ # .
g ! . . @